64

35
data/tiles/00_SpaceScraperA.txt
data/tiles/01_SpaceScraperB.txt
data/tiles/02_SpaceScraperC.txt
data/tiles/03_TowerLinkA.txt
data/tiles/04_TowerLinkB.txt
data/tiles/05_Ground.txt
data/tiles/06_SideWorldA.txt
data/tiles/07_SideWorldB.txt
data/tiles/08_SideWorldC.txt
data/tiles/09_SideWorldD.txt
data/tiles/10_SideWorldE.txt
data/tiles/11_HSpaceScraperA.txt
data/tiles/12_HSpaceScraperB.txt
data/tiles/13_HSPaceScraperC.txt
data/tiles/14_RSideWorldA.txt
data/tiles/15_RSideWorldB.txt
data/tiles/16_RSideWorldC.txt
data/tiles/17_RSideWorldD.txt
data/tiles/18_RSideWorldE.txt
data/tiles/19_RHSpaceScraperA.txt
data/tiles/20_RHSpaceScraperB.txt
data/tiles/21_RHSpaceScraperC.txt
data/tiles/22_AGreenSkunk.txt
data/tiles/23_NinjaCello.txt
data/tiles/24_MoveZig.txt
data/tiles/25_RnAWings.txt
data/tiles/26_PipeMtH.txt
data/tiles/27_PipeLtM.txt
data/tiles/28_PipeHtM.txt
data/tiles/29_PipeMtL.txt
data/tiles/30_PipeL.txt
data/tiles/31_PipeM.txt
data/tiles/32_PipeH.txt
data/tiles/33_BabyBoard.txt
data/tiles/34_NeptuneBoard.txt

2 1 0 0.5
109 19
-1 -1 -1 -1 -1 -1 -1 -1 -1 -1 -1 -1 -1 -1 -1 -1 -1 -1 -1 -1 -1 -1 -1 -1 -1 -1 -1 -1 -1 -1 -1 -1 -1 -1 -1 -1 -1 -1 -1 -1 -1 -1 -1 -1 -1 -1 -1 -1 -1 -1 -1 -1 -1 -1 -1 -1 -1 -1 -1 -1 -1 -1 -1 -1 -1 -1 -1 -1 -1 -1 -1 -1 -1 -1 -1 -1 -1 -1 -1 -1 -1 -1 -1 -1 -1 -1 -1 -1 -1 -1 -1 -1 -1 -1 -1 -1 -1 -1 -1 -1 -1 -1 -1 -1 -1 -1 -1 -1 -1
-1 -1 -1 -1 -1 -1 -1 -1 -1 -1 -1 -1 -1 -1 -1 -1 -1 -1 -1 -1 -1 -1 -1 -1 -1 -1 -1 -1 -1 -1 -1 -1 -1 -1 -1 -1 -1 -1 -1 -1 -1 -1 -1 -1 -1 -1 -1 -1 -1 -1 -1 -1 -1 -1 -1 -1 -1 -1 -1 -1 -1 -1 -1 -1 -1 -1 -1 -1 -1 -1 -1 -1 -1 -1 -1 -1 -1 -1 -1 -1 -1 -1 -1 -1 -1 -1 -1 -1 -1 -1 -1 -1 -1 -1 -1 -1 -1 -1 -1 -1 -1 -1 -1 -1 -1 -1 -1 -1 -1
-1 -1 -1 -1 -1 -1 -1 -1 -1 -1 -1 -1 -1 -1 -1 -1 -1 -1 -1 -1 -1 -1 -1 -1 -1 -1 -1 -1 -1 -1 -1 -1 -1 -1 -1 -1 -1 -1 -1 -1 -1 -1 -1 -1 -1 -1 -1 -1 -1 -1 -1 -1 -1 -1 -1 -1 -1 -1 -1 -1 -1 -1 -1 -1 -1 -1 -1 -1 -1 -1 -1 -1 -1 -1 -1 -1 -1 -1 -1 -1 -1 -1 -1 -1 -1 -1 -1 -1 00 01 02 -1 -1 -1 -1 -1 -1 -1 -1 -1 -1 -1 -1 -1 -1 -1 -1 -1 -1
-1 -1 -1 -1 -1 -1 -1 -1 -1 -1 -1 -1 -1 -1 -1 -1 -1 -1 -1 -1 -1 -1 -1 -1 -1 -1 -1 -1 -1 -1 -1 -1 -1 -1 -1 -1 -1 -1 -1 -1 -1 -1 -1 -1 -1 -1 -1 -1 -1 -1 -1 -1 -1 -1 -1 -1 -1 -1 -1 -1 -1 -1 -1 -1 -1 -1 -1 -1 -1 -1 -1 -1 -1 -1 -1 -1 -1 -1 -1 -1 -1 -1 -1 -1 -1 -1 -1 19 15 03 -1 34 00 01 02 -1 -1 -1 -1 -1 -1 -1 -1 -1 -1 -1 -1 -1 -1
-1 -1 -1 -1 -1 -1 -1 -1 -1 -1 -1 -1 -1 -1 -1 -1 -1 -1 -1 -1 -1 -1 -1 -1 -1 -1 -1 -1 -1 -1 -1 -1 -1 -1 -1 -1 -1 -1 -1 -1 -1 -1 -1 -1 -1 -1 -1 -1 -1 -1 -1 -1 -1 -1 -1 -1 -1 -1 -1 -1 -1 -1 -1 -1 -1 -1 -1 -1 -1 -1 -1 -1 -1 -1 -1 -1 -1 -1 -1 -1 -1 -1 -1 -1 -1 -1 -1 20 16 04 -1 04 26 03 -1 -1 -1 -1 -1 -1 -1 -1 -1 -1 -1 -1 -1 -1 -1
-1 -1 -1 -1 -1 -1 -1 -1 -1 -1 -1 -1 -1 -1 -1 -1 -1 -1 -1 -1 -1 -1 -1 -1 -1 -1 -1 -1 -1 -1 -1 -1 -1 -1 -1 -1 -1 -1 -1 -1 -1 -1 -1 -1 -1 -1 -1 00 01 02 -1 -1 -1 -1 -1 -1 -1 -1 -1 -1 -1 -1 -1 -1 -1 -1 -1 -1 -1 -1 -1 -1 -1 -1 -1 -1 00 01 02 -1 -1 -1 -1 -1 -1 -1 -1 21 17 03 -1 03 28 04 -1 -1 -1 -1 -1 -1 -1 -1 -1 -1 00 01 02 -1 -1
-1 -1 -1 -1 -1 -1 -1 -1 -1 -1 -1 -1 -1 -1 -1 -1 -1 -1 -1 -1 -1 -1 -1 -1 -1 -1 -1 -1 -1 -1 -1 -1 -1 -1 -1 -1 -1 -1 -1 -1 -1 -1 -1 -1 -1 00 01 02 03 -1 -1 -1 -1 -1 -1 -1 -1 -1 -1 -1 -1 -1 -1 -1 -1 -1 -1 -1 -1 -1 -1 -1 -1 -1 -1 -1 -1 03 30 30 30 30 30 30 30 27 31 31 31 04 -1 04 26 03 -1 -1 -1 00 01 02 -1 -1 -1 -1 -1 03 -1 -1 -1
-1 -1 -1 -1 -1 -1 -1 -1 -1 -1 -1 -1 -1 -1 -1 -1 -1 -1 -1 -1 -1 -1 -1 -1 -1 -1 -1 -1 -1 -1 -1 -1 -1 -1 -1 -1 -1 -1 -1 -1 -1 -1 -1 -1 -1 -1 03 26 04 -1 -1 -1 -1 -1 -1 -1 -1 -1 -1 -1 -1 -1 -1 -1 -1 -1 -1 -1 -1 -1 -1 -1 -1 -1 -1 -1 -1 04 07 11 -1 -1 -1 -1 -1 -1 19 15 14 03 -1 03 28 04 06 07 11 -1 03 -1 00 01 02 -1 -1 04 00 01 02
-1 -1 -1 -1 -1 -1 -1 -1 -1 00 01 02 -1 -1 -1 -1 -1 -1 -1 -1 -1 -1 -1 -1 -1 -1 -1 -1 -1 -1 -1 -1 -1 -1 -1 -1 -1 -1 -1 -1 -1 -1 -1 -1 -1 -1 04 29 03 -1 -1 -1 -1 -1 -1 -1 -1 -1 -1 -1 -1 -1 -1 -1 00 01 01 01 02 -1 -1 -1 -1 -1 -1 -1 -1 03 08 12 -1 -1 -1 -1 -1 -1 20 16 31 04 -1 04 26 03 28 08 12 -1 04 -1 -1 03 00 01 02 03 27 03 -1
-1 -1 -1 -1 -1 -1 -1 -1 -1 -1 03 -1 -1 -1 -1 -1 -1 -1 -1 -1 -1 -1 -1 -1 -1 -1 -1 -1 -1 -1 -1 -1 -1 -1 -1 -1 -1 -1 00 01 02 -1 -1 -1 -1 -1 03 27 04 29 30 30 30 30 27 26 32 32 32 28 29 30 30 30 30 03 03 03 30 27 31 31 31 31 29 27 26 04 09 13 -1 -1 -1 -1 -1 -1 21 17 18 03 -1 03 28 04 10 09 13 -1 03 -1 -1 04 27 03 27 04 31 04 -1
-1 -1 -1 -1 -1 -1 -1 -1 -1 -1 04 -1 -1 -1 -1 -1 -1 -1 -1 -1 -1 -1 -1 -1 -1 -1 00 01 02 -1 -1 -1 -1 -1 -1 -1 -1 -1 -1 03 30 30 27 31 29 27 04 26 03 -1 -1 -1 -1 -1 -1 -1 -1 -1 -1 -1 -1 -1 -1 -1 -1 04 04 04 -1 -1 -1 -1 -1 -1 -1 -1 -1 03 -1 -1 -1 -1 -1 -1 -1 00 01 02 -1 04 -1 04 26 03 -1 -1 -1 -1 04 -1 -1 03 27 04 28 03 30 03 -1
-1 -1 -1 -1 -1 -1 -1 -1 -1 -1 03 -1 00 01 02 -1 -1 -1 -1 -1 -1 -1 -1 -1 00 01 02 03 00 01 02 -1 -1 -1 -1 -1 -1 -1 -1 04 -1 -1 00 01 02 -1 03 -1 04 -1 -1 -1 -1 -1 -1 -1 -1 -1 -1 -1 -1 -1 -1 -1 -1 03 03 03 -1 -1 -1 -1 -1 -1 -1 -1 -1 04 31 31 26 32 32 32 32 32 03 28 26 03 34 03 28 04 29 30 27 26 03 -1 -1 04 27 03 26 04 31 04 -1
-1 -1 -1 -1 -1 -1 -1 -1 -1 -1 04 31 26 03 -1 -1 -1 -1 -1 -1 -1 -1 00 01 02 03 27 04 29 03 28 31 31 31 31 31 31 31 29 03 28 31 26 03 -1 -1 05 05 05 33 -1 -1 -1 -1 -1 -1 -1 -1 -1 -1 -1 -1 -1 -1 -1 04 05 05 -1 -1 -1 -1 -1 -1 -1 19 15 03 -1 -1 -1 -1 -1 -1 -1 -1 04 -1 -1 15 03 07 -1 03 -1 -1 -1 -1 04 -1 23 03 27 04 28 03 32 03 -1
30 30 30 30 27 31 31 31 31 26 03 28 31 04 29 30 30 30 30 27 31 31 26 03 05 05 05 05 05 04 29 30 30 27 31 29 30 30 27 04 29 30 27 04 -1 05 05 05 05 05 -1 -1 -1 -1 -1 -1 -1 -1 -1 -1 22 -1 -1 -1 -1 03 05 05 -1 -1 -1 -1 -1 -1 -1 20 16 04 -1 -1 -1 -1 -1 -1 24 -1 03 27 31 16 04 08 31 04 -1 -1 -1 05 05 05 05 05 05 03 27 04 31 04 29
-1 -1 04 04 -1 05 05 05 05 28 04 31 26 03 00 01 02 -1 -1 -1 00 01 02 05 05 05 05 05 05 03 -1 06 07 11 -1 19 15 14 -1 03 27 31 29 03 26 05 05 05 05 05 -1 -1 00 02 00 02 -1 -1 -1 24 03 23 -1 -1 -1 05 05 05 -1 -1 -1 -1 -1 -1 -1 21 17 03 -1 -1 -1 -1 -1 -1 03 27 04 05 05 17 03 09 05 05 -1 -1 -1 05 05 05 05 05 05 04 27 03 31 03 -1
-1 03 03 03 05 05 07 15 05 05 03 -1 05 05 32 03 -1 00 01 01 02 03 05 05 05 05 05 05 05 04 31 31 08 12 -1 20 16 29 27 04 00 01 02 04 -1 05 05 05 05 05 28 31 15 07 15 07 11 -1 23 03 03 03 24 -1 -1 05 05 05 28 31 31 31 31 29 30 30 27 04 29 30 30 30 30 27 04 -1 05 05 05 03 03 03 05 05 05 -1 34 05 05 05 05 05 05 03 28 04 31 04 -1
04 04 04 04 05 05 09 17 05 05 04 05 05 05 05 04 31 29 03 03 28 05 05 05 05 05 05 05 05 03 33 10 09 13 22 21 17 18 -1 03 -1 03 -1 05 05 05 05 05 05 05 05 05 17 09 17 09 13 25 03 03 03 03 03 28 26 05 05 05 05 05 05 05 05 05 05 05 05 03 05 05 05 05 05 05 03 25 05 05 05 04 04 04 05 05 05 05 05 05 05 05 05 05 05 04 -1 03 25 03 -1
05 05 05 05 05 05 05 05 05 05 05 05 05 05 05 05 05 05 05 05 05 05 05 05 05 05 05 05 05 05 05 05 05 05 05 05 05 05 05 05 05 05 05 05 05 05 05 05 05 05 05 05 05 05 05 05 05 05 05 05 05 05 05 05 05 05 05 05 05 05 05 05 05 05 05 05 05 05 05 05 05 05 05 05 05 05 05 05 05 05 05 05 05 05 05 05 05 05 05 05 05 05 05 05 05 05 05 05 05
05 05 05 05 05 05 05 05 05 05 05 05 05 05 05 05 05 05 05 05 05 05 05 05 05 05 05 05 05 05 05 05 05 05 05 05 05 05 05 05 05 05 05 05 05 05 05 05 05 05 05 05 05 05 05 05 05 05 05 05 05 05 05 05 05 05 05 05 05 05 05 05 05 05 05 05 05 05 05 05 05 05 05 05 05 05 05 05 05 05 05 05 05 05 05 05 05 05 05 05 05 05 05 05 05 05 05 05 05