64

49
data/tiles/00_SpaceScraperA.txt
data/tiles/01_SpaceScraperB.txt
data/tiles/02_SpaceScraperC.txt
data/tiles/03_TowerLinkA.txt
data/tiles/04_TowerLinkB.txt
data/tiles/05_Ground.txt
data/tiles/06_SideWorldA.txt
data/tiles/07_SideWorldB.txt
data/tiles/08_SideWorldC.txt
data/tiles/09_SideWorldD.txt
data/tiles/10_SideWorldE.txt
data/tiles/11_HSpaceScraperA.txt
data/tiles/12_HSpaceScraperB.txt
data/tiles/13_HSPaceScraperC.txt
data/tiles/14_RSideWorldA.txt
data/tiles/15_RSideWorldB.txt
data/tiles/16_RSideWorldC.txt
data/tiles/17_RSideWorldD.txt
data/tiles/18_RSideWorldE.txt
data/tiles/19_RHSpaceScraperA.txt
data/tiles/20_RHSpaceScraperB.txt
data/tiles/21_RHSpaceScraperC.txt
data/tiles/22_AGreenSkunk.txt
data/tiles/23_NinjaCello.txt
data/tiles/24_MoveZig.txt
data/tiles/25_RnAWings.txt
data/tiles/26_PipeMtH.txt
data/tiles/27_PipeLtM.txt
data/tiles/28_PipeHtM.txt
data/tiles/29_PipeMtL.txt
data/tiles/30_PipeL.txt
data/tiles/31_PipeM.txt
data/tiles/32_PipeH.txt
data/tiles/33_BabyBoard.txt
data/tiles/34_NeptuneBoard.txt
data/tiles/35_MazeFlat.txt
data/tiles/36_MazeUp.txt
data/tiles/37_MazeDown.txt
data/tiles/38_RMazeDown.txt
data/tiles/39_RMazeUp.txt
data/tiles/40_DeathTile.txt
data/tiles/41_BBodyA.txt
data/tiles/42_BBodyB.txt
data/tiles/43_BCoreA.txt
data/tiles/44_BCoreC.txt
data/tiles/45_SpreadA.txt
data/tiles/46_SpreadB.txt
data/tiles/47_Spawner.txt
data/tiles/48_Core.txt

2 0 0 1.0
400 10
-1 -1 -1 -1 -1 -1 -1 -1 -1 -1 -1 -1 -1 -1 -1 -1 -1 -1 -1 -1 -1 -1 -1 -1 -1 -1 -1 -1 -1 -1 -1 -1 -1 -1 -1 -1 -1 -1 -1 -1 -1 -1 -1 -1 -1 -1 -1 -1 -1 -1 -1 -1 -1 -1 -1 -1 -1 -1 -1 -1 -1 -1 -1 -1 -1 -1 -1 -1 -1 -1 -1 -1 -1 -1 -1 -1 -1 -1 -1 -1 -1 -1 -1 -1 -1 -1 -1 -1 -1 -1 -1 -1 -1 -1 -1 -1 -1 -1 -1 -1 -1 -1 -1 -1 -1 -1 -1 -1 -1 -1 -1 -1 -1 -1 -1 -1 -1 -1 -1 -1 -1 -1 -1 -1 -1 -1 -1 -1 -1 -1 -1 -1 -1 -1 -1 -1 -1 -1 -1 -1 -1 -1 -1 -1 -1 -1 -1 -1 -1 -1 -1 -1 -1 -1 -1 38 35 35 35 35 35 35 35 35 35 35 35 35 35 35 35 35 35 35 35 35 35 35 35 35 35 35 35 35 35 35 35 35 35 35 35 35 35 35 35 35 35 35 35 35 35 35 35 35 35 35 35 35 35 35 35 35 35 35 35 35 35 35 35 35 35 35 35 35 35 35 35 35 35 35 35 35 35 35 35 35 35 35 35 35 05 05 05 35 39 -1 -1 38 35 05 05 05 05 05 05 35 35 35 35 35 35 35 35 35 35 35 35 35 35 35 35 35 39 38 35 35 35 35 39 -1 -1 -1 -1 -1 -1 -1 -1 -1 -1 -1 -1 -1 -1 -1 05 05 35 35 35 35 35 35 35 35 35 35 35 35 35 35 35 35 35 35 35 35 35 35 35 35 35 35 39 -1 -1 -1 -1 -1 -1 19 15 35 35 35 35 35 35 35 35 35 35 35 35 35 35 35 35 35 35 35 35 35 35 35 35 35 35 35 35 35 35 35 35 35 35 35 35 35 35 35 35 35 35 35 35 35 35 35 35 35 35 35 39 -1 -1 -1 -1 -1 -1 -1 -1 -1 -1 -1 -1 -1 -1 19 15 35
-1 -1 -1 -1 -1 -1 -1 -1 -1 -1 -1 -1 -1 -1 -1 -1 -1 -1 -1 -1 -1 -1 -1 -1 -1 -1 -1 -1 -1 -1 -1 -1 -1 -1 -1 -1 -1 -1 -1 -1 -1 -1 -1 -1 -1 -1 -1 -1 -1 -1 -1 -1 -1 -1 -1 -1 -1 -1 -1 -1 -1 -1 -1 -1 -1 -1 -1 -1 -1 -1 -1 -1 -1 -1 -1 -1 -1 -1 -1 -1 -1 -1 -1 -1 -1 -1 -1 -1 -1 -1 -1 -1 -1 -1 -1 -1 -1 -1 -1 -1 -1 -1 -1 -1 -1 -1 -1 -1 -1 -1 -1 -1 -1 -1 -1 -1 -1 -1 -1 -1 -1 -1 -1 -1 -1 -1 -1 -1 -1 -1 -1 -1 -1 -1 -1 -1 -1 -1 -1 -1 -1 -1 -1 -1 -1 -1 -1 -1 -1 -1 -1 -1 -1 -1 -1 -1 -1 -1 -1 -1 -1 -1 -1 -1 -1 -1 -1 -1 -1 -1 -1 -1 -1 -1 -1 -1 -1 -1 -1 -1 -1 -1 -1 -1 -1 -1 -1 -1 -1 -1 -1 -1 -1 -1 -1 -1 -1 -1 -1 -1 -1 -1 -1 -1 -1 -1 -1 -1 -1 -1 -1 -1 -1 -1 -1 -1 -1 -1 -1 -1 -1 -1 -1 -1 -1 -1 -1 -1 -1 -1 -1 -1 -1 -1 -1 -1 -1 -1 -1 38 35 05 05 35 -1 -1 -1 -1 38 35 05 05 05 05 35 39 38 35 35 35 35 35 35 35 35 35 35 35 35 35 35 39 -1 -1 38 35 35 39 -1 -1 -1 -1 -1 -1 -1 -1 -1 -1 -1 -1 -1 -1 -1 -1 05 05 35 35 35 35 35 35 35 35 35 39 38 37 03 03 36 39 38 35 35 35 35 39 38 35 35 39 -1 -1 -1 -1 -1 -1 -1 20 16 35 35 35 39 -1 38 35 35 35 39 00 01 02 -1 38 35 35 35 39 -1 -1 36 35 39 -1 -1 -1 -1 -1 -1 -1 -1 -1 38 35 35 35 35 35 35 35 35 35 35 35 35 35 35 35 35 39 -1 -1 -1 -1 -1 -1 -1 -1 -1 -1 -1 -1 -1 -1 -1 47 16 35
-1 -1 -1 -1 -1 -1 -1 -1 -1 -1 -1 -1 -1 -1 -1 -1 -1 -1 -1 -1 -1 -1 -1 -1 -1 -1 -1 -1 -1 -1 -1 -1 -1 -1 -1 -1 -1 -1 -1 -1 -1 -1 -1 -1 -1 -1 -1 -1 -1 -1 -1 -1 -1 -1 -1 -1 -1 -1 -1 -1 -1 -1 -1 -1 -1 -1 -1 -1 -1 -1 -1 -1 -1 -1 -1 -1 -1 -1 -1 -1 -1 -1 -1 -1 -1 -1 -1 -1 -1 -1 -1 -1 -1 -1 -1 -1 -1 -1 -1 -1 -1 -1 -1 -1 -1 -1 -1 -1 -1 -1 -1 -1 -1 -1 -1 -1 -1 -1 -1 -1 -1 -1 -1 -1 -1 -1 -1 -1 -1 -1 -1 -1 -1 -1 -1 -1 -1 -1 -1 -1 -1 -1 -1 -1 -1 -1 -1 -1 -1 -1 -1 -1 -1 -1 -1 -1 -1 -1 -1 -1 -1 -1 -1 -1 -1 -1 -1 -1 -1 -1 -1 -1 -1 -1 -1 -1 -1 -1 -1 -1 -1 -1 -1 -1 -1 -1 -1 -1 -1 -1 -1 -1 -1 -1 -1 -1 -1 -1 -1 -1 -1 -1 -1 -1 -1 -1 -1 -1 -1 -1 -1 -1 -1 -1 -1 -1 -1 -1 -1 -1 -1 -1 -1 -1 -1 -1 -1 -1 -1 -1 -1 -1 -1 -1 -1 -1 -1 -1 -1 -1 38 35 05 35 -1 -1 -1 -1 -1 38 35 05 05 05 35 -1 -1 38 35 35 35 35 35 35 35 35 35 35 35 35 39 -1 -1 -1 -1 38 39 -1 -1 -1 -1 -1 -1 -1 -1 -1 -1 -1 -1 -1 -1 -1 -1 -1 05 05 35 35 39 38 35 35 35 35 39 -1 -1 38 35 35 39 -1 -1 38 37 36 39 -1 -1 -1 -1 -1 -1 -1 -1 -1 -1 -1 -1 21 17 35 35 35 00 01 02 35 35 39 -1 -1 03 00 01 02 35 35 39 -1 -1 36 35 39 -1 -1 -1 -1 -1 -1 -1 -1 -1 -1 -1 38 35 35 35 35 35 35 35 35 35 35 35 35 35 35 39 -1 -1 -1 -1 -1 -1 -1 -1 -1 -1 -1 -1 -1 -1 -1 45 41 17 35
-1 -1 -1 -1 -1 -1 -1 -1 -1 -1 -1 -1 -1 -1 -1 -1 -1 -1 -1 -1 -1 -1 -1 -1 -1 -1 -1 -1 -1 -1 -1 -1 -1 -1 -1 -1 -1 -1 -1 -1 -1 -1 -1 -1 -1 -1 -1 -1 -1 -1 -1 -1 -1 -1 -1 -1 -1 -1 -1 -1 -1 -1 -1 -1 -1 -1 -1 -1 -1 -1 -1 -1 -1 -1 -1 -1 -1 -1 -1 -1 -1 -1 -1 -1 -1 -1 -1 -1 -1 -1 -1 -1 -1 -1 -1 -1 -1 -1 -1 -1 -1 -1 -1 -1 -1 -1 -1 -1 -1 -1 -1 -1 -1 -1 -1 -1 -1 -1 -1 -1 -1 -1 -1 -1 -1 -1 -1 -1 -1 -1 -1 -1 -1 -1 -1 -1 -1 -1 -1 -1 -1 -1 -1 -1 -1 -1 -1 -1 -1 -1 -1 -1 -1 -1 -1 -1 -1 -1 -1 -1 -1 -1 -1 -1 -1 -1 -1 -1 -1 -1 -1 -1 -1 -1 -1 -1 -1 -1 -1 -1 -1 -1 -1 -1 -1 -1 -1 -1 -1 -1 -1 -1 -1 -1 -1 -1 -1 -1 -1 -1 -1 -1 -1 -1 -1 -1 -1 -1 -1 -1 -1 -1 -1 -1 -1 -1 -1 -1 -1 -1 -1 -1 -1 -1 -1 -1 -1 -1 -1 -1 -1 -1 -1 -1 -1 -1 -1 -1 -1 -1 -1 38 35 39 -1 -1 -1 -1 -1 -1 38 35 05 35 39 -1 -1 -1 38 35 35 35 35 39 38 35 35 35 35 39 -1 -1 -1 -1 -1 -1 -1 -1 -1 36 -1 -1 -1 -1 -1 -1 -1 -1 -1 -1 -1 -1 -1 -1 05 05 35 39 -1 -1 38 37 36 39 -1 -1 -1 -1 38 39 -1 -1 -1 -1 38 39 -1 -1 -1 -1 -1 -1 -1 -1 -1 -1 -1 -1 -1 -1 -1 -1 38 35 37 03 36 35 39 -1 -1 34 04 26 03 36 35 39 -1 -1 -1 -1 -1 -1 -1 36 35 35 35 35 35 37 -1 -1 -1 -1 38 35 35 35 35 35 35 35 35 35 39 -1 -1 -1 -1 -1 -1 -1 -1 -1 -1 -1 -1 -1 -1 -1 -1 -1 -1 -1 -1 43 15 35
-1 -1 -1 -1 -1 -1 -1 -1 -1 -1 -1 -1 -1 -1 -1 -1 -1 -1 -1 -1 -1 -1 -1 -1 -1 -1 -1 -1 -1 -1 -1 -1 -1 -1 -1 -1 -1 -1 -1 -1 -1 -1 -1 -1 -1 -1 -1 -1 -1 -1 -1 -1 -1 -1 -1 -1 -1 -1 -1 -1 00 01 02 -1 -1 -1 -1 -1 -1 -1 -1 -1 -1 -1 -1 -1 -1 -1 -1 -1 -1 -1 -1 -1 -1 -1 -1 -1 -1 -1 -1 -1 -1 -1 -1 -1 -1 -1 33 -1 -1 -1 -1 -1 -1 -1 -1 -1 -1 -1 -1 -1 -1 -1 00 01 02 -1 -1 -1 -1 -1 -1 -1 -1 -1 -1 -1 -1 22 -1 -1 -1 -1 -1 -1 -1 00 01 02 -1 -1 -1 -1 -1 -1 -1 -1 -1 -1 -1 -1 -1 -1 -1 -1 -1 -1 -1 -1 -1 -1 -1 -1 -1 -1 -1 -1 -1 -1 -1 -1 -1 -1 -1 -1 -1 -1 -1 -1 -1 -1 -1 -1 -1 -1 -1 -1 -1 -1 -1 -1 -1 -1 -1 -1 -1 -1 -1 -1 -1 -1 -1 -1 -1 -1 -1 -1 -1 -1 -1 -1 -1 -1 -1 -1 -1 -1 -1 -1 -1 -1 -1 -1 -1 -1 -1 -1 -1 -1 -1 -1 -1 -1 -1 -1 -1 -1 -1 -1 -1 -1 -1 -1 -1 -1 -1 -1 -1 -1 -1 38 35 39 -1 -1 -1 -1 -1 38 35 35 39 -1 -1 38 35 35 39 -1 -1 -1 36 37 -1 -1 -1 -1 36 35 -1 -1 -1 -1 -1 -1 -1 -1 -1 -1 -1 -1 -1 -1 35 35 39 -1 -1 -1 -1 38 39 -1 -1 -1 -1 -1 -1 -1 -1 -1 -1 -1 -1 -1 -1 -1 -1 -1 -1 -1 -1 -1 -1 -1 -1 -1 -1 -1 -1 -1 -1 38 35 35 35 39 -1 36 35 35 35 35 35 35 39 -1 -1 -1 -1 -1 -1 -1 36 35 35 35 35 35 35 35 37 -1 -1 -1 -1 38 35 35 35 35 35 35 35 39 -1 -1 -1 -1 -1 -1 -1 -1 -1 -1 -1 -1 -1 -1 -1 -1 -1 -1 -1 -1 -1 48 16 35
-1 -1 -1 -1 -1 -1 -1 -1 -1 -1 -1 -1 -1 -1 -1 -1 -1 00 01 02 -1 00 01 02 -1 -1 -1 -1 -1 -1 00 01 01 01 02 -1 -1 -1 -1 -1 -1 -1 -1 -1 -1 -1 -1 -1 -1 -1 -1 -1 -1 -1 -1 -1 -1 -1 -1 19 15 03 07 11 -1 -1 -1 -1 -1 -1 -1 -1 -1 -1 -1 -1 -1 -1 -1 -1 -1 -1 -1 -1 -1 -1 -1 -1 -1 -1 -1 -1 -1 -1 23 -1 19 15 03 28 29 30 30 30 30 27 31 29 30 30 30 30 30 27 26 03 30 30 30 27 31 29 30 27 26 32 32 28 31 04 -1 -1 -1 00 01 02 -1 -1 03 07 11 -1 -1 -1 -1 -1 -1 -1 -1 -1 -1 -1 -1 -1 -1 -1 -1 -1 -1 -1 -1 -1 -1 -1 -1 -1 -1 -1 -1 -1 -1 -1 -1 -1 -1 -1 -1 -1 -1 -1 -1 -1 -1 -1 -1 -1 -1 -1 -1 -1 -1 -1 -1 -1 -1 -1 -1 -1 -1 -1 -1 -1 -1 -1 -1 05 05 -1 -1 -1 -1 -1 -1 -1 -1 -1 -1 -1 -1 -1 -1 -1 -1 -1 -1 -1 -1 -1 -1 -1 -1 -1 -1 -1 -1 -1 -1 -1 -1 -1 -1 -1 -1 -1 -1 -1 -1 -1 -1 -1 -1 -1 -1 -1 -1 36 37 -1 -1 -1 38 39 -1 -1 -1 -1 38 39 -1 -1 -1 36 39 38 37 -1 -1 36 39 05 -1 -1 -1 -1 -1 -1 00 01 02 -1 -1 -1 -1 -1 -1 -1 -1 -1 -1 -1 -1 -1 -1 -1 -1 36 37 -1 -1 -1 -1 36 37 -1 -1 -1 -1 36 37 -1 -1 -1 -1 -1 -1 -1 -1 -1 -1 -1 -1 -1 -1 -1 -1 -1 -1 -1 -1 -1 -1 -1 -1 -1 -1 -1 -1 -1 -1 36 35 35 35 35 35 35 35 35 35 35 35 35 35 37 -1 -1 -1 -1 38 35 39 -1 38 35 39 -1 -1 -1 -1 -1 -1 -1 -1 -1 -1 -1 -1 -1 -1 -1 -1 -1 -1 -1 -1 -1 -1 44 17 35
01 02 -1 -1 -1 19 15 14 00 01 02 -1 -1 -1 -1 -1 -1 -1 03 00 01 02 03 -1 -1 -1 25 -1 19 15 14 03 03 03 06 07 11 -1 -1 -1 -1 -1 -1 -1 -1 -1 00 01 02 -1 -1 -1 -1 -1 -1 -1 -1 -1 -1 20 16 04 08 12 00 01 02 -1 -1 -1 -1 -1 -1 -1 -1 -1 -1 -1 -1 00 01 02 06 07 11 -1 -1 -1 -1 -1 -1 -1 -1 24 03 -1 20 16 04 06 07 11 -1 -1 -1 -1 05 32 32 32 32 32 32 28 31 04 -1 -1 -1 00 01 02 -1 -1 19 15 14 -1 -1 03 -1 -1 -1 -1 03 00 01 02 04 08 12 -1 -1 -1 -1 -1 -1 -1 -1 -1 -1 -1 -1 -1 -1 -1 -1 -1 00 01 02 -1 -1 -1 -1 -1 -1 -1 -1 -1 -1 -1 -1 -1 -1 -1 -1 -1 -1 -1 -1 -1 -1 -1 -1 -1 -1 -1 -1 -1 -1 -1 -1 -1 -1 -1 -1 -1 -1 -1 -1 -1 -1 -1 -1 05 05 -1 -1 -1 -1 -1 -1 -1 05 -1 -1 -1 -1 -1 -1 -1 -1 -1 -1 -1 -1 -1 -1 -1 -1 -1 -1 -1 -1 -1 -1 -1 -1 -1 -1 36 05 37 -1 -1 -1 -1 -1 -1 -1 -1 -1 -1 36 35 35 37 -1 -1 -1 -1 -1 -1 -1 -1 -1 -1 -1 -1 36 39 -1 -1 38 37 36 39 24 05 -1 -1 -1 -1 00 01 02 03 07 11 -1 -1 -1 -1 -1 -1 -1 -1 36 37 -1 -1 -1 -1 36 39 38 37 -1 -1 36 35 35 37 -1 -1 36 39 38 37 -1 -1 -1 -1 -1 -1 -1 -1 -1 00 01 02 -1 -1 -1 -1 -1 -1 -1 -1 -1 -1 -1 -1 -1 -1 -1 -1 -1 -1 -1 -1 -1 38 39 -1 -1 -1 -1 -1 38 35 35 39 -1 -1 -1 -1 -1 -1 -1 -1 -1 -1 -1 -1 -1 36 35 35 37 -1 -1 -1 -1 -1 -1 -1 -1 -1 -1 -1 -1 -1 -1 -1 46 42 15 35
03 -1 06 07 11 20 16 26 32 03 00 01 02 -1 -1 -1 -1 -1 04 26 03 28 04 -1 -1 -1 03 -1 20 16 31 04 05 04 31 08 12 -1 -1 -1 -1 03 -1 -1 00 01 02 03 00 01 02 -1 -1 -1 -1 -1 -1 -1 -1 21 17 03 09 13 -1 03 -1 -1 06 07 15 07 15 14 -1 00 01 02 -1 -1 03 27 31 08 12 00 01 01 01 01 02 -1 -1 03 04 -1 21 17 03 28 08 12 -1 -1 22 05 05 06 07 15 07 15 07 15 14 03 -1 -1 -1 34 03 24 -1 -1 20 16 29 30 27 04 31 31 31 31 04 26 03 32 03 09 13 -1 -1 -1 -1 -1 -1 -1 -1 -1 -1 -1 -1 -1 -1 -1 00 01 02 03 -1 -1 -1 -1 -1 -1 -1 -1 -1 -1 -1 -1 -1 -1 -1 -1 -1 -1 -1 -1 -1 -1 -1 -1 -1 -1 -1 -1 -1 -1 -1 -1 -1 -1 -1 05 05 -1 -1 -1 -1 06 07 11 -1 05 05 -1 -1 -1 00 01 02 05 05 -1 -1 -1 -1 -1 -1 -1 -1 -1 -1 -1 -1 -1 -1 -1 -1 -1 -1 -1 -1 -1 -1 -1 -1 -1 36 05 05 35 00 01 02 -1 -1 -1 -1 -1 -1 36 35 39 38 35 37 -1 -1 -1 -1 36 37 -1 -1 -1 -1 36 39 00 01 01 02 38 35 35 35 05 -1 -1 -1 -1 -1 03 -1 04 08 12 -1 -1 -1 -1 -1 -1 -1 36 39 38 37 -1 -1 36 35 35 35 35 37 36 39 03 03 38 37 36 39 -1 -1 38 35 35 37 -1 -1 -1 -1 00 01 02 03 -1 -1 -1 -1 -1 -1 -1 -1 -1 36 35 37 -1 -1 36 35 37 -1 -1 -1 -1 -1 -1 -1 -1 36 37 -1 -1 -1 38 39 -1 -1 -1 -1 -1 -1 -1 36 35 37 -1 -1 -1 36 35 35 35 35 37 -1 -1 -1 -1 -1 -1 -1 -1 -1 -1 -1 -1 -1 -1 -1 47 16 35
04 31 31 08 12 21 17 18 -1 04 29 03 -1 -1 -1 -1 -1 33 03 28 04 26 03 24 -1 03 03 03 21 17 18 05 05 05 10 09 13 -1 -1 -1 03 03 03 -1 -1 03 28 04 26 03 28 31 31 31 31 29 30 30 30 30 27 04 26 32 28 04 31 31 31 08 16 08 16 31 31 26 03 27 29 27 04 -1 10 09 13 -1 03 03 03 03 30 27 31 04 03 28 31 31 04 10 09 13 -1 -1 05 05 05 28 08 16 08 16 08 16 31 04 31 29 30 03 04 03 -1 -1 21 17 18 24 -1 03 27 31 31 26 03 28 04 31 04 31 31 31 31 31 31 31 31 31 31 31 31 31 31 31 31 31 29 03 27 04 00 01 02 -1 -1 00 01 02 -1 -1 -1 -1 -1 -1 -1 -1 -1 -1 36 35 35 35 35 35 35 37 -1 -1 -1 -1 -1 05 05 -1 -1 05 05 -1 -1 05 05 28 08 12 -1 05 05 -1 -1 05 -1 03 -1 05 05 -1 -1 -1 -1 -1 -1 -1 -1 -1 -1 -1 -1 -1 -1 -1 -1 -1 -1 -1 -1 -1 -1 -1 -1 36 05 05 05 05 -1 03 -1 -1 -1 -1 -1 -1 36 35 39 -1 -1 38 35 37 -1 -1 36 39 38 37 -1 -1 36 35 27 26 03 03 28 29 35 35 35 35 27 31 31 31 31 04 26 03 09 13 -1 -1 -1 -1 -1 -1 36 39 22 34 38 37 36 35 35 35 35 35 35 35 35 35 35 35 35 35 35 35 35 35 35 35 35 37 33 -1 -1 -1 03 28 04 -1 24 -1 -1 -1 -1 -1 36 35 35 35 35 37 36 35 35 35 35 35 35 35 37 -1 -1 36 35 35 37 -1 -1 -1 -1 -1 -1 -1 36 35 35 35 35 35 35 35 35 35 35 35 35 35 35 35 37 -1 -1 -1 -1 -1 -1 -1 -1 -1 -1 -1 -1 -1 -1 21 17 35
05 05 05 05 05 05 05 05 05 05 05 05 05 05 05 05 05 05 05 05 05 05 05 05 05 05 05 05 05 05 05 05 05 05 05 05 05 05 05 05 05 05 05 05 05 05 05 05 05 05 05 05 05 05 05 05 05 05 05 05 05 05 05 05 05 05 05 05 05 05 05 05 05 05 05 05 05 05 05 05 05 05 05 05 05 05 05 05 05 05 05 05 05 05 05 05 05 05 05 05 05 05 05 05 05 05 05 05 05 05 05 05 05 05 05 05 05 05 05 05 05 05 05 05 05 05 05 05 05 05 05 05 05 05 05 05 05 05 05 05 05 05 05 05 05 05 05 05 05 05 05 05 05 05 37 40 40 04 40 03 32 03 40 00 01 02 03 40 40 40 40 40 40 40 40 40 40 36 05 05 05 05 05 05 05 05 37 40 40 40 40 05 05 40 40 05 05 40 40 05 05 10 09 13 40 05 05 40 40 05 40 04 40 05 05 40 40 40 40 40 40 40 40 40 40 40 40 40 40 40 40 40 40 40 40 40 40 40 36 05 05 05 05 05 05 05 05 05 05 05 05 05 05 05 05 05 05 05 05 05 37 36 39 -1 -1 38 37 36 05 05 05 05 05 05 05 05 05 05 05 05 05 05 05 05 05 05 05 05 05 05 05 05 05 05 05 05 05 05 05 05 05 05 05 05 05 05 05 05 05 05 05 05 05 05 05 05 05 05 05 05 05 05 05 05 05 05 05 05 05 05 05 05 05 05 05 05 05 05 05 05 05 05 05 05 05 05 05 05 05 05 05 05 05 05 05 05 05 05 05 05 05 05 05 05 05 05 05 05 05 05 05 05 05 05 05 05 05 05 05 05 05 05 05 37 40 40 40 40 40 40 40 40 40 40 40 40 40 40 40 35


