64

33
data/tiles/00_SpaceScraperA.txt
data/tiles/01_SpaceScraperB.txt
data/tiles/02_SpaceScraperC.txt
data/tiles/03_TowerLinkA.txt
data/tiles/04_TowerLinkB.txt
data/tiles/05_Ground.txt
data/tiles/06_SideWorldA.txt
data/tiles/07_SideWorldB.txt
data/tiles/08_SideWorldC.txt
data/tiles/09_SideWorldD.txt
data/tiles/10_SideWorldE.txt
data/tiles/11_HSpaceScraperA.txt
data/tiles/12_HSpaceScraperB.txt
data/tiles/13_HSPaceScraperC.txt
data/tiles/14_RSideWorldA.txt
data/tiles/15_RSideWorldB.txt
data/tiles/16_RSideWorldC.txt
data/tiles/17_RSideWorldD.txt
data/tiles/18_RSideWorldE.txt
data/tiles/19_RHSpaceScraperA.txt
data/tiles/20_RHSpaceScraperB.txt
data/tiles/21_RHSpaceScraperC.txt
data/tiles/22_AGreenSkunk.txt
data/tiles/23_NinjaCello.txt
data/tiles/24_MoveZig.txt
data/tiles/25_RnAWings.txt
data/tiles/26_PipeMtH.txt
data/tiles/27_PipeLtM.txt
data/tiles/28_PipeHtM.txt
data/tiles/29_PipeMtL.txt
data/tiles/30_PipeL.txt
data/tiles/31_PipeM.txt
data/tiles/32_PipeH.txt


2 0 0 1.0
109 10
-1 -1 -1 -1 -1 -1 -1 -1 -1 -1 -1 -1 -1 -1 -1 -1 -1 -1 -1 -1 -1 -1 -1 -1 -1 -1 -1 -1 -1 -1 -1 -1 -1 -1 -1 -1 -1 -1 -1 -1 -1 -1 -1 -1 -1 -1 -1 -1 -1 -1 -1 -1 -1 -1 -1 -1 -1 -1 -1 -1 -1 -1 -1 -1 -1 -1 -1 -1 -1 -1 -1 -1 -1 -1 -1 -1 -1 -1 -1 -1 -1 -1 -1 -1 -1 -1 -1 -1 -1 -1 -1 -1 -1 -1 -1 -1 -1 -1 -1 -1 -1 -1 -1 -1 -1 -1 03 05 -1
-1 -1 -1 -1 -1 32 28 31 29 30 27 26 -1 -1 -1 -1 -1 -1 -1 -1 -1 -1 -1 -1 -1 -1 -1 -1 -1 -1 -1 -1 -1 -1 -1 -1 -1 -1 -1 -1 -1 -1 -1 -1 -1 -1 -1 -1 -1 -1 -1 -1 -1 -1 -1 -1 -1 -1 -1 -1 -1 -1 -1 -1 -1 -1 -1 -1 -1 -1 -1 -1 -1 -1 -1 -1 -1 -1 -1 -1 -1 -1 -1 -1 -1 -1 -1 -1 -1 -1 -1 -1 -1 -1 -1 -1 -1 -1 -1 -1 -1 -1 -1 -1 -1 22 04 05 -1
-1 -1 -1 -1 -1 -1 -1 -1 -1 -1 -1 22 23 24 25 -1 -1 -1 -1 06 -1 -1 -1 -1 -1 -1 -1 -1 -1 06 -1 -1 -1 -1 -1 -1 06 -1 -1 -1 -1 -1 -1 -1 -1 -1 -1 -1 -1 -1 -1 -1 -1 -1 -1 -1 -1 00 01 02 -1 -1 -1 -1 -1 -1 -1 -1 -1 -1 -1 -1 -1 -1 -1 -1 -1 -1 -1 -1 -1 -1 -1 -1 -1 -1 -1 -1 -1 -1 -1 -1 -1 -1 -1 -1 -1 -1 -1 -1 -1 -1 -1 -1 -1 -1 03 05 -1
-1 -1 -1 -1 -1 -1 -1 -1 -1 -1 -1 -1 -1 -1 -1 -1 -1 -1 -1 -1 -1 -1 -1 -1 -1 -1 -1 -1 -1 -1 -1 -1 -1 -1 -1 -1 -1 -1 -1 -1 -1 -1 -1 -1 -1 -1 -1 -1 -1 -1 -1 -1 -1 -1 -1 -1 -1 -1 04 -1 -1 -1 -1 -1 -1 -1 -1 -1 -1 -1 -1 -1 -1 -1 -1 -1 -1 -1 -1 -1 -1 -1 -1 -1 -1 -1 -1 -1 -1 -1 -1 -1 -1 -1 -1 -1 -1 -1 -1 -1 -1 -1 -1 -1 -1 23 04 05 -1
-1 -1 -1 -1 -1 -1 22 -1 -1 -1 -1 -1 -1 -1 -1 -1 -1 -1 -1 -1 -1 -1 -1 -1 -1 -1 -1 -1 -1 -1 -1 -1 -1 -1 -1 -1 -1 -1 -1 -1 -1 -1 -1 -1 -1 -1 -1 -1 -1 -1 -1 -1 -1 00 01 01 02 -1 03 -1 -1 -1 -1 -1 -1 -1 -1 -1 -1 -1 -1 -1 -1 -1 -1 -1 -1 -1 -1 -1 -1 -1 -1 -1 -1 -1 -1 -1 -1 -1 -1 -1 -1 -1 -1 -1 -1 -1 -1 -1 -1 -1 -1 -1 -1 -1 03 05 -1
-1 -1 -1 -1 -1 19 15 14 -1 -1 -1 00 01 02 -1 -1 -1 -1 -1 -1 -1 06 07 11 -1 00 01 02 -1 -1 -1 -1 -1 -1 -1 -1 -1 -1 -1 -1 -1 -1 -1 -1 -1 -1 -1 -1 -1 -1 -1 -1 -1 -1 04 04 -1 -1 04 -1 -1 -1 -1 -1 -1 -1 -1 -1 -1 -1 -1 -1 -1 -1 -1 -1 -1 -1 -1 -1 -1 -1 -1 -1 -1 -1 -1 -1 -1 -1 -1 -1 -1 -1 -1 -1 -1 -1 -1 -1 -1 -1 -1 -1 -1 24 04 05 -1
-1 -1 -1 -1 -1 20 16 -1 -1 -1 -1 -1 04 00 01 02 -1 -1 -1 -1 -1 -1 08 12 -1 -1 04 -1 -1 -1 -1 -1 -1 -1 -1 -1 -1 00 01 01 01 01 02 -1 -1 -1 -1 -1 -1 -1 -1 -1 -1 -1 03 03 -1 -1 03 -1 -1 -1 -1 00 01 02 -1 -1 -1 -1 -1 -1 -1 -1 00 01 02 -1 -1 -1 -1 -1 -1 -1 -1 -1 -1 -1 -1 -1 -1 -1 -1 -1 00 01 02 -1 -1 -1 -1 -1 -1 -1 -1 -1 03 05 -1
-1 -1 -1 -1 -1 21 17 18 -1 -1 -1 -1 03 -1 04 -1 -1 00 01 02 -1 10 09 13 -1 -1 03 -1 -1 -1 -1 -1 -1 -1 -1 -1 -1 -1 04 04 04 04 -1 -1 -1 -1 -1 -1 -1 -1 -1 -1 -1 -1 04 05 05 05 04 -1 -1 -1 -1 -1 04 -1 -1 -1 -1 -1 -1 -1 -1 -1 -1 04 -1 -1 -1 -1 -1 -1 -1 -1 00 01 02 -1 -1 -1 -1 -1 -1 -1 -1 04 -1 -1 -1 -1 -1 -1 22 -1 -1 25 04 05 -1
05 05 05 05 05 05 05 05 05 05 05 05 05 05 05 05 05 05 05 05 05 05 05 05 05 05 05 05 05 05 05 05 05 05 05 05 05 05 05 05 05 05 05 05 05 05 05 05 05 05 05 05 05 05 05 05 05 05 05 05 05 05 05 05 05 05 05 05 05 05 05 05 05 05 05 05 05 05 05 05 05 05 05 05 05 05 05 05 05 05 05 05 05 05 05 05 05 05 05 05 05 05 05 05 05 05 05 05 -1
05 05 05 05 05 05 05 05 05 05 05 05 05 05 05 05 05 05 05 05 05 05 05 05 05 05 05 05 05 05 05 05 05 05 05 05 05 05 05 05 05 05 05 05 05 05 05 05 05 05 05 05 05 05 05 05 05 05 05 05 05 05 05 05 05 05 05 05 05 05 05 05 05 05 05 05 05 05 05 05 05 05 05 05 05 05 05 05 05 05 05 05 05 05 05 05 05 05 05 05 05 05 05 05 05 05 05 05 -1
